################
#0 0  0000    0#
#0   000   0  0#
#0        0   0#
#   000     0 0#
#0000   0000000#
#0  00  000  0 #
#0      000  00#
#00000  00    0#
#0          000#
#00 0  000     #
#0  0   0  000 #
#   00 00 0000 #
#00  0 00 000  #
#0  00 00     0#
################